The Hideout
+----------+XX+
|         *|XX|
|         *|==|
|   ***   *|==|
|         *|==|
|         *|==|
+-#--------+==|
|             |
|             |
+-#---+--#-+--+
|     |    |  |
|     | *  |  |
| * * | *  |  |
|     | *  # B|
| * * |    |BB|
+-----+----+--+
