The Smithy
..............
.+-#--------+.
.|1         |.
.|    ***** |.
.|1  1*1    |.
.|    *     |.
.+----++#+##|.
.|BBB | @|==|.
.|BB  #  |==|.
.|B   |  |XX|.
.+----+  +--+.
.|..........|.
.+..........+.
..............
.+.+.+..+.+.+.
..............
