The Smithy
..............
.+-#--------+.
.|1         |.
.|    ***** |.
.|1  1*1    |.
.|    *     |.
.+----++#+##|.
.|XXXX|  |==|.
.|XXXX#  |==|.
.|XXXX|  |XX|.
.+----+  +--+.
.|..........|.
.+..........+.
..............
.+.+.+..+.+.+.
..............
