Breakout!
+--#-+--+
|    |  |
| *  |  |
| *3 |  |
| * 4 5B|
|   2|BB|
+----+--+
